0000000000 ---
0000000000
0002220000
0000000000
0000000200
0000200000
0200000000
0000000000
0020000000
0000022000
0000000000 --- ok
0000000200
0000000000
0000000220
0000220000
0000000000
0002220000
0000000000
0000002000
0002000000
0000000220 --- ok
0022000000
0000000000
0000020000
0000000000
0002000200
0000000000
0020002220
0000000000
0000220000
0000000000 --- ok
0002002200
0200000000
0000000020
0022200000
0000002200
0002000000
0000020000
0200000000
0002002000 - 2560
3333333333
3333333333
3333333333
3333333333

